###############
#      MXXXXX #
#  @          #
#             #
#             #
#  M          #
#  B          #
#  B   S     W#
#  B   F      #
#             #
#         F   #
#         B   #
#            $#
#        XXXX #
###############
