###############
#  #@#M  F$#  #
#  #    MB #  #
#  #     W #  #
#  #      ##  #
#  #B XBN# #  #
#  ##      #  #
#  #       #  #
#  #     W #  #
#  #      ##  #
#  #B XBN# #  #
#  ##      #  #
#  #       #  #
#  #     W #  #
#  #      ##  #
#  #B XBN# #  #
#  ##      #  #
#  #       #  #
#  #       #  #
#  #      ##  #
#  #  XBMF #  #
#  #########  #
#             #
# ##### ##### #
# #     #     #
# #     #  ## #
# #     #   # #
# ##### ##### #
#             #
###############
