###################
#@                #
#                 #
################# #
########  #  #    #
#                 #
#        # # # #  #
# #################
#  ################
#   ###############
#    ##############
#      ############
#       ###########
#       $##########
###################
