########
#@E  FX#
#X #  $#
#XN F* #
########
