########
#     $#
#      #
#      #
#  @   #
#      #
#      #
########
