##########
# @      #
# B      #
#XXX     #
# B      #
#    BXX$#
#XXXXXXXX#
#        #
#        #
##########
