##########
#    M   #
#        #
#       $#
#       @#
#        #
#       M#
#        #
#        #
##########
