##########
#    F   #
#        #
#        #
#        #
#@       #
#        #
#        #
#    F  $#
##########
