##########
#        #
#  @     #
#  B     #
#  S   W #
# XXX    #
#  B   N #
# XXXXXXX#
#       $#
##########
