###############
#      MXXXXX #
#  @          #
#E S          #
#             #
#  M          #
#  B          #
#  B   S     W#
#  B   F      #
#             #
#         F   #
#         B   #
#N          W$#
#        XXXX #
###############
