###################
#@                #
#                 #
################# #
########  #  #M W #
#S            M#  #
#        # # ### M#
# #################
#  ################
#   ###############
#    ##############
#      ############
#       ###########
#M      $##########
###################
