#####
#@  #
#   #
#   #
#####
#  $#
#####
