#####
#   #
# @ #
#BXB#
#####
#  $#
#####
