##########
#3      @#
# 16X    #
#XX7X    #
#  X     #
#  X     #
#$XX     #
##########
