##########
#3 4 3 1@#
# 16X    #
#XX7X   4#
#  #     #
#  X   1 #
#$ X   2 #
##########
