##########
#3 4 3 1@#
# 16X    #
#XX7X    #
#  #     #
#  X   1 #
#$ X   2 #
##########
