##############
#         @  #
#         *  #
#            #
#      @  *  #
#      #     #
#            #
#            #
#$           #
##############
