##############
#         @  #
#         *  #
#         *  #
#      @     #
#      #     #
#            #
#            #
#$           #
##############
